{
    "1": {
        "TextureSet": "debug",
        "Spawn": [0,0],
        "level":[
            "n",
            "n",
            "n",
            "n",
            "n",
            "n",
            "__________________________eeee_________c_________________________________________________________________________________________________________________________________________",
            "_________________________________________________________________________________________________________________c____________________________________c___________e_____________",
            "________________c______________________e______________________________c_____________________________________e__________p_______________________________p_______#########_________",
            "_________________________________#############__________________________________________________________________________________________e________________________________________",
            "_________________________________###########__________________________p___________________________________________c_________########################_____________________________",
            "#############_____#_######################_______________e_________________________e___________________________________p______####################______p____e___________________",
            "____________________________________________________###########_______________###########_________________________p_________________________________________p____________________",
            "_________________________________________________############___________________############________________p___________________________e________________________________________",
            "__________________________c___________________#############_______________________#############____________________________________________________________________c____________x",
            "#############_______################################################################################################################_________####################################"
        ]
    },
    "2": {
        "TextureSet": "debug",
        "Spawn": [0,0],
        "level":[
            "____________________c_________________________________________________________________________c________________________________________c_______________c_____________e__________x",
            "____________________e_________________________________________________________________________p_________________________e____p____###########__________p__________###############",
            "_______________###########_______________________________e__________________________####_____________####_______________p________________________________________________________",
            "_________________###########____p___________________###########___________________####_________________####_______p_________________________________########_____________________",
            "________________________________________________________________________c_______####_____________________####____________________________________________________________________",
            "___________________________________###############               ###############____________________________________________________________________________e________________c___",
            "______________________p__________###############___________________###########_________________e_________________________________________________e_____###########________#######",
            "_________c______p__________c______________________________________________________c______#############________________________________e_____######################________#######",
            "*________e____________e__________________________________p_____________e__________p______________________________________________#################################________#######",
            "#################################################________________#############___________________________________#################################################________#######"

        ]
    }
}